18 12
8 8
8 9
8 5

111111111111111111111
100000000000000000001
100000111111111000001
100000100000001000001
100000100040001000001
100000100000001000001
100000111111111000001
100000000000000000001
100000000000000000001
100000000000000000001
100000000000000000001
111111111111111111111
