22 14
10 11
11 11
10 4

111111111111111111111111
100000000000000000000001
100000000000000000000001
100000000011100000000001
100000000000000000000001
100000111111111111000001
100000000000000000000001
100000000040000000000001
100000000000000000000001
100000111111111111000001
100000000000000000000001
100000000000000000000001
100000000000000000000001
111111111111111111111111
